11111111111111111111111111111111111
1P0000C10000000000000100000C0000001
10111111011111011111010111111111011
10000000000000000001000000100010001
11110111110111111101111101110111101
10010000000100000100000101000100001
10110101111101110101111101011101111
1000010000000C110001000000010001001
11111101011111111100011111110111001
100000010100000C0001010001000001101
10111111010111011111010111011100001
1000000C000001000001010000000001101
11111111110111011111010101110111101
100000000001000100000000010001000C1
10111111111101110111111011011101111
10000C00000001C001000000000000000E1
11111111111111111111111111111111111