1111111111111
1C01000000001
1110011101101
1P0111E001C01
1111111111111