1111111111111
1C01000000001
1000011101101
1P0111E011C01
1111111111111